Agrinatveg-Alpine.for	forests/trees/europe/alpine/agriculture_and_natural_vegetation/forest.for
Agrinatveg-Atlantic.for	forests/trees/europe/atlantic/agriculture_and_natural_vegetation/forest.for
Agrinatveg-Blacksea.for	forests/trees/europe/black_sea/agriculture_and_natural_vegetation/forest.for
Agrinatveg-Boreal.for	forests/trees/europe/boreal/agriculture_and_natural_vegetation/forest.for
Agrinatveg-Continental.for	forests/trees/europe/continental/agriculture_and_natural_vegetation/forest.for
Agrinatveg-Macaronesia.for	forests/trees/europe/macaronesia/agriculture_and_natural_vegetation/forest.for
Agrinatveg-Mediterranean.for	forests/trees/europe/mediterranean/agriculture_and_natural_vegetation/forest.for
Agrinatveg-Pannonian.for	forests/trees/europe/pannonian/agriculture_and_natural_vegetation/forest.for
Agrinatveg-Steppic.for	forests/trees/europe/steppic/agriculture_and_natural_vegetation/forest.for
Broadleaf-Alpine.for	forests/trees/europe/alpine/broad_leaf/forest.for
Broadleaf-Atlantic.for	forests/trees/europe/atlantic/broad_leaf/forest.for
Broadleaf-Blacksea.for	forests/trees/europe/black_sea/broad_leaf/forest.for
Broadleaf-Boreal.for	forests/trees/europe/boreal/broad_leaf/forest.for
Broadleaf-Continental.for	forests/trees/europe/continental/broad_leaf/forest.for
Broadleaf-Macaronesia.for	forests/trees/europe/macaronesia/broad_leaf/forest.for
Broadleaf-Mediterranean.for	forests/trees/europe/mediterranean/broad_leaf/forest.for
Broadleaf-Pannonian.for	forests/trees/europe/pannonian/broad_leaf/forest.for
Broadleaf-Steppic.for	forests/trees/europe/steppic/broad_leaf/forest.for
Conifer-Alpine.for	forests/trees/europe/alpine/conifer/forest.for
Conifer-Atlantic.for	forests/trees/europe/atlantic/conifer/forest.for
Conifer-Blacksea.for	forests/trees/europe/black_sea/conifer/forest.for
Conifer-Boreal.for	forests/trees/europe/boreal/conifer/forest.for
Conifer-Continental.for	forests/trees/europe/continental/conifer/forest.for
Conifer-Macaronesia.for	forests/trees/europe/macaronesia/conifer/forest.for
Conifer-Mediterranean.for	forests/trees/europe/mediterranean/conifer/forest.for
Conifer-Pannonian.for	forests/trees/europe/pannonian/conifer/forest.for
Conifer-Steppic.for	forests/trees/europe/steppic/conifer/forest.for
Fruit-Alpine.for	forests/trees/europe/alpine/fruit/forest.for
Fruit-Atlantic.for	forests/trees/europe/atlantic/fruit/forest.for
Fruit-Blacksea.for	forests/trees/europe/black_sea/fruit/forest.for
Fruit-Boreal.for	forests/trees/europe/boreal/fruit/forest.for
Fruit-Continental.for	forests/trees/europe/continental/fruit/forest.for
Fruit-Macaronesia.for	forests/trees/europe/macaronesia/fruit/forest.for
Fruit-Mediterranean.for	forests/trees/europe/mediterranean/fruit/forest.for
Fruit-Pannonian.for	forests/trees/europe/pannonian/fruit/forest.for
Fruit-Steppic.for	forests/trees/europe/steppic/fruit/forest.for
Heathland-Alpine.for	forests/trees/europe/alpine/heathland/forest.for
Heathland-Atlantic.for	forests/trees/europe/atlantic/heathland/forest.for
Heathland-Blacksea.for	forests/trees/europe/black_sea/heathland/forest.for
Heathland-Boreal.for	forests/trees/europe/boreal/heathland/forest.for
Heathland-Continental.for	forests/trees/europe/continental/heathland/forest.for
Heathland-Macaronesia.for	forests/trees/europe/macaronesia/heathland/forest.for
Heathland-Mediterranean.for	forests/trees/europe/mediterranean/heathland/forest.for
Heathland-Pannonian.for	forests/trees/europe/pannonian/heathland/forest.for
Heathland-Steppic.for	forests/trees/europe/steppic/heathland/forest.for
Mixed-Alpine.for	forests/trees/europe/alpine/mixed/forest.for
Mixed-Atlantic.for	forests/trees/europe/atlantic/mixed/forest.for
Mixed-Blacksea.for	forests/trees/europe/black_sea/mixed/forest.for
Mixed-Boreal.for	forests/trees/europe/boreal/mixed/forest.for
Mixed-Continental.for	forests/trees/europe/continental/mixed/forest.for
Mixed-Macaronesia.for	forests/trees/europe/macaronesia/mixed/forest.for
Mixed-Mediterranean.for	forests/trees/europe/mediterranean/mixed/forest.for
Mixed-Pannonian.for	forests/trees/europe/pannonian/mixed/forest.for
Mixed-Steppic.for	forests/trees/europe/steppic/mixed/forest.for
Olive-Alpine.for	forests/trees/europe/alpine/olive/forest.for
Olive-Atlantic.for	forests/trees/europe/atlantic/olive/forest.for
Olive-Blacksea.for	forests/trees/europe/black_sea/olive/forest.for
Olive-Continental.for	forests/trees/europe/continental/olive/forest.for
Olive-Macaronesia.for	forests/trees/europe/macaronesia/olive/forest.for
Olive-Mediterranean.for	forests/trees/europe/mediterranean/olive/forest.for
Olive-Pannonian.for	forests/trees/europe/pannonian/olive/forest.for
Olive-Steppic.for	forests/trees/europe/steppic/olive/forest.for
Pastures-Alpine.for	forests/trees/europe/alpine/pasture/forest.for
Pastures-Atlantic.for	forests/trees/europe/atlantic/pasture/forest.for
Pastures-Blacksea.for	forests/trees/europe/black_sea/pasture/forest.for
Pastures-Boreal.for	forests/trees/europe/boreal/pasture/forest.for
Pastures-Continental.for	forests/trees/europe/continental/pasture/forest.for
Pastures-Macaronesia.for	forests/trees/europe/macaronesia/pasture/forest.for
Pastures-Mediterranean.for	forests/trees/europe/mediterranean/pasture/forest.for
Pastures-Pannonian.for	forests/trees/europe/pannonian/pasture/forest.for
Pastures-Steppic.for	forests/trees/europe/steppic/pasture/forest.for
Sclerophyllous-Alpine.for	forests/trees/europe/alpine/sclerophyllous/forest.for
Sclerophyllous-Atlantic.for	forests/trees/europe/atlantic/sclerophyllous/forest.for
Sclerophyllous-Blacksea.for	forests/trees/europe/black_sea/sclerophyllous/forest.for
Sclerophyllous-Continental.for	forests/trees/europe/continental/sclerophyllous/forest.for
Sclerophyllous-Macaronesia.for	forests/trees/europe/macaronesia/sclerophyllous/forest.for
Sclerophyllous-Mediterranean.for	forests/trees/europe/mediterranean/sclerophyllous/forest.for
Sclerophyllous-Pannonian.for	forests/trees/europe/pannonian/sclerophyllous/forest.for
Sclerophyllous-Steppic.for	forests/trees/europe/steppic/sclerophyllous/forest.for
Shrub-Alpine.for	forests/trees/europe/alpine/shrub/forest.for
Shrub-Atlantic.for	forests/trees/europe/atlantic/shrub/forest.for
Shrub-Blacksea.for	forests/trees/europe/black_sea/shrub/forest.for
Shrub-Boreal.for	forests/trees/europe/boreal/shrub/forest.for
Shrub-Continental.for	forests/trees/europe/continental/shrub/forest.for
Shrub-Macaronesia.for	forests/trees/europe/macaronesia/shrub/forest.for
Shrub-Mediterranean.for	forests/trees/europe/mediterranean/shrub/forest.for
Shrub-Pannonian.for	forests/trees/europe/pannonian/shrub/forest.for
Shrub-Steppic.for	forests/trees/europe/steppic/shrub/forest.for