deciduous_dense-adirondack_new_england.for	forests/trees/usa/adirondack_new_england/deciduous_dense/forest.for
deciduous_dense-american_semi_desert_and_desert.for	forests/trees/usa/american_semi_desert_and_desert/deciduous_dense/forest.for
deciduous_dense-arizona_new_mexico.for	forests/trees/usa/arizona_new_mexico/deciduous_dense/forest.for
deciduous_dense-black_hills.for	forests/trees/usa/black_hills/deciduous_dense/forest.for
deciduous_dense-california_coastal_chapparra.for	forests/trees/usa/california_coastal_chapparra/deciduous_dense/forest.for
deciduous_dense-california_coastal_range.for	forests/trees/usa/california_coastal_range/deciduous_dense/forest.for
deciduous_dense-california_coastal_redwood.for	forests/trees/usa/california_coastal_redwood/deciduous_dense/forest.for
deciduous_dense-california_dry_steppe.for	forests/trees/usa/california_dry_steppe/deciduous_dense/forest.for
deciduous_dense-cascade.for	forests/trees/usa/cascade/deciduous_dense/forest.for
deciduous_dense-central_appalachian.for	forests/trees/usa/central_appalachian/deciduous_dense/forest.for
deciduous_dense-chihuahuan_semi_desert.for	forests/trees/usa/chihuahuan_semi_desert/deciduous_dense/forest.for
deciduous_dense-colorado_plateau_semi_desert.for	forests/trees/usa/colorado_plateau_semi_desert/deciduous_dense/forest.for
deciduous_dense-eastern_continental.for	forests/trees/usa/eastern_continental/deciduous_dense/forest.for
deciduous_dense-eastern_oceanic.for	forests/trees/usa/eastern_oceanic/deciduous_dense/forest.for
deciduous_dense-everglades_coast.for	forests/trees/usa/everglades_coast/deciduous_dense/forest.for
deciduous_dense-everglades.for	forests/trees/usa/everglades/deciduous_dense/forest.for
deciduous_dense-great_plains_palouse_dry_steppe.for	forests/trees/usa/great_plains_palouse_dry_steppe/deciduous_dense/forest.for
deciduous_dense-great_plains_steppe_and_shrub.for	forests/trees/usa/great_plains_steppe_and_shrub/deciduous_dense/forest.for
deciduous_dense-great_plains_steppe.for	forests/trees/usa/great_plains_steppe/deciduous_dense/forest.for
deciduous_dense-hawaiian_islands.for	forests/trees/usa/hawaiian_islands/deciduous_dense/forest.for
deciduous_dense-intermountain_semi_desert_and_desert.for	forests/trees/usa/intermountain_semi_desert_and_desert/deciduous_dense/forest.for
deciduous_dense-intermountain_semi_desert.for	forests/trees/usa/intermountain_semi_desert/deciduous_dense/forest.for
deciduous_dense-laurentian.for	forests/trees/usa/laurentian/deciduous_dense/forest.for
deciduous_dense-lower_mississippi_riverine.for	forests/trees/usa/lower_mississippi_riverine/deciduous_dense/forest.for
deciduous_dense-middle_rocky_mountain.for	forests/trees/usa/middle_rocky_mountain/deciduous_dense/forest.for
deciduous_dense-nevada_utah_mountains.for	forests/trees/usa/nevada_utah_mountains/deciduous_dense/forest.for
deciduous_dense-northern_rocky_mountain.for	forests/trees/usa/northern_rocky_mountain/deciduous_dense/forest.for
deciduous_dense-ouachita.for	forests/trees/usa/ouachita/deciduous_dense/forest.for
deciduous_dense-outer_coastal_plain.for	forests/trees/usa/outer_coastal_plain/deciduous_dense/forest.for
deciduous_dense-ozark.for	forests/trees/usa/ozark/deciduous_dense/forest.for
deciduous_dense-pacific_lowland.for	forests/trees/usa/pacific_lowland/deciduous_dense/forest.for
deciduous_dense-prairie_parkland_subtropical.for	forests/trees/usa/prairie_parkland_subtropical/deciduous_dense/forest.for
deciduous_dense-prairie_parkland_temperate.for	forests/trees/usa/prairie_parkland_temperate/deciduous_dense/forest.for
deciduous_dense-sierran_steppe_sequoias.for	forests/trees/usa/sierran_steppe_sequoias/deciduous_dense/forest.for
deciduous_dense-sierran_steppe.for	forests/trees/usa/sierran_steppe/deciduous_dense/forest.for
deciduous_dense-southeastern.for	forests/trees/usa/southeastern/deciduous_dense/forest.for
deciduous_dense-southern_rocky_mountain.for	forests/trees/usa/southern_rocky_mountain/deciduous_dense/forest.for
deciduous_dense-southwest_plateau_and_plains.for	forests/trees/usa/southwest_plateau_and_plains/deciduous_dense/forest.for
deciduous_sparse-adirondack_new_england.for	forests/trees/usa/adirondack_new_england/deciduous_sparse/forest.for
deciduous_sparse-american_semi_desert_and_desert.for	forests/trees/usa/american_semi_desert_and_desert/deciduous_sparse/forest.for
deciduous_sparse-arizona_new_mexico.for	forests/trees/usa/arizona_new_mexico/deciduous_sparse/forest.for
deciduous_sparse-black_hills.for	forests/trees/usa/black_hills/deciduous_sparse/forest.for
deciduous_sparse-california_coastal_chapparra.for	forests/trees/usa/california_coastal_chapparra/deciduous_sparse/forest.for
deciduous_sparse-california_coastal_range.for	forests/trees/usa/california_coastal_range/deciduous_sparse/forest.for
deciduous_sparse-california_coastal_redwood.for	forests/trees/usa/california_coastal_redwood/deciduous_sparse/forest.for
deciduous_sparse-california_dry_steppe.for	forests/trees/usa/california_dry_steppe/deciduous_sparse/forest.for
deciduous_sparse-cascade.for	forests/trees/usa/cascade/deciduous_sparse/forest.for
deciduous_sparse-central_appalachian.for	forests/trees/usa/central_appalachian/deciduous_sparse/forest.for
deciduous_sparse-chihuahuan_semi_desert.for	forests/trees/usa/chihuahuan_semi_desert/deciduous_sparse/forest.for
deciduous_sparse-colorado_plateau_semi_desert.for	forests/trees/usa/colorado_plateau_semi_desert/deciduous_sparse/forest.for
deciduous_sparse-eastern_continental.for	forests/trees/usa/eastern_continental/deciduous_sparse/forest.for
deciduous_sparse-eastern_oceanic.for	forests/trees/usa/eastern_oceanic/deciduous_sparse/forest.for
deciduous_sparse-everglades_coast.for	forests/trees/usa/everglades_coast/deciduous_sparse/forest.for
deciduous_sparse-everglades.for	forests/trees/usa/everglades/deciduous_sparse/forest.for
deciduous_sparse-great_plains_palouse_dry_steppe.for	forests/trees/usa/great_plains_palouse_dry_steppe/deciduous_sparse/forest.for
deciduous_sparse-great_plains_steppe_and_shrub.for	forests/trees/usa/great_plains_steppe_and_shrub/deciduous_sparse/forest.for
deciduous_sparse-great_plains_steppe.for	forests/trees/usa/great_plains_steppe/deciduous_sparse/forest.for
deciduous_sparse-hawaiian_islands.for	forests/trees/usa/hawaiian_islands/deciduous_sparse/forest.for
deciduous_sparse-intermountain_semi_desert_and_desert.for	forests/trees/usa/intermountain_semi_desert_and_desert/deciduous_sparse/forest.for
deciduous_sparse-intermountain_semi_desert.for	forests/trees/usa/intermountain_semi_desert/deciduous_sparse/forest.for
deciduous_sparse-laurentian.for	forests/trees/usa/laurentian/deciduous_sparse/forest.for
deciduous_sparse-lower_mississippi_riverine.for	forests/trees/usa/lower_mississippi_riverine/deciduous_sparse/forest.for
deciduous_sparse-middle_rocky_mountain.for	forests/trees/usa/middle_rocky_mountain/deciduous_sparse/forest.for
deciduous_sparse-nevada_utah_mountains.for	forests/trees/usa/nevada_utah_mountains/deciduous_sparse/forest.for
deciduous_sparse-northern_rocky_mountain.for	forests/trees/usa/northern_rocky_mountain/deciduous_sparse/forest.for
deciduous_sparse-ouachita.for	forests/trees/usa/ouachita/deciduous_sparse/forest.for
deciduous_sparse-outer_coastal_plain.for	forests/trees/usa/outer_coastal_plain/deciduous_sparse/forest.for
deciduous_sparse-ozark.for	forests/trees/usa/ozark/deciduous_sparse/forest.for
deciduous_sparse-pacific_lowland.for	forests/trees/usa/pacific_lowland/deciduous_sparse/forest.for
deciduous_sparse-prairie_parkland_subtropical.for	forests/trees/usa/prairie_parkland_subtropical/deciduous_sparse/forest.for
deciduous_sparse-prairie_parkland_temperate.for	forests/trees/usa/prairie_parkland_temperate/deciduous_sparse/forest.for
deciduous_sparse-sierran_steppe_sequoias.for	forests/trees/usa/sierran_steppe_sequoias/deciduous_sparse/forest.for
deciduous_sparse-sierran_steppe.for	forests/trees/usa/sierran_steppe/deciduous_sparse/forest.for
deciduous_sparse-southeastern.for	forests/trees/usa/southeastern/deciduous_sparse/forest.for
deciduous_sparse-southern_rocky_mountain.for	forests/trees/usa/southern_rocky_mountain/deciduous_sparse/forest.for
deciduous_sparse-southwest_plateau_and_plains.for	forests/trees/usa/southwest_plateau_and_plains/deciduous_sparse/forest.for
evergreen_dense-adirondack_new_england.for	forests/trees/usa/adirondack_new_england/evergreen_dense/forest.for
evergreen_dense-american_semi_desert_and_desert.for	forests/trees/usa/american_semi_desert_and_desert/evergreen_dense/forest.for
evergreen_dense-arizona_new_mexico.for	forests/trees/usa/arizona_new_mexico/evergreen_dense/forest.for
evergreen_dense-black_hills.for	forests/trees/usa/black_hills/evergreen_dense/forest.for
evergreen_dense-california_coastal_chapparra.for	forests/trees/usa/california_coastal_chapparra/evergreen_dense/forest.for
evergreen_dense-california_coastal_range.for	forests/trees/usa/california_coastal_range/evergreen_dense/forest.for
evergreen_dense-california_coastal_redwood.for	forests/trees/usa/california_coastal_redwood/evergreen_dense/forest.for
evergreen_dense-california_dry_steppe.for	forests/trees/usa/california_dry_steppe/evergreen_dense/forest.for
evergreen_dense-cascade.for	forests/trees/usa/cascade/evergreen_dense/forest.for
evergreen_dense-central_appalachian.for	forests/trees/usa/central_appalachian/evergreen_dense/forest.for
evergreen_dense-chihuahuan_semi_desert.for	forests/trees/usa/chihuahuan_semi_desert/evergreen_dense/forest.for
evergreen_dense-colorado_plateau_semi_desert.for	forests/trees/usa/colorado_plateau_semi_desert/evergreen_dense/forest.for
evergreen_dense-eastern_continental.for	forests/trees/usa/eastern_continental/evergreen_dense/forest.for
evergreen_dense-eastern_oceanic.for	forests/trees/usa/eastern_oceanic/evergreen_dense/forest.for
evergreen_dense-everglades_coast.for	forests/trees/usa/everglades_coast/evergreen_dense/forest.for
evergreen_dense-everglades.for	forests/trees/usa/everglades/evergreen_dense/forest.for
evergreen_dense-great_plains_palouse_dry_steppe.for	forests/trees/usa/great_plains_palouse_dry_steppe/evergreen_dense/forest.for
evergreen_dense-great_plains_steppe_and_shrub.for	forests/trees/usa/great_plains_steppe_and_shrub/evergreen_dense/forest.for
evergreen_dense-great_plains_steppe.for	forests/trees/usa/great_plains_steppe/evergreen_dense/forest.for
evergreen_dense-hawaiian_islands.for	forests/trees/usa/hawaiian_islands/evergreen_dense/forest.for
evergreen_dense-intermountain_semi_desert_and_desert.for	forests/trees/usa/intermountain_semi_desert_and_desert/evergreen_dense/forest.for
evergreen_dense-intermountain_semi_desert.for	forests/trees/usa/intermountain_semi_desert/evergreen_dense/forest.for
evergreen_dense-laurentian.for	forests/trees/usa/laurentian/evergreen_dense/forest.for
evergreen_dense-lower_mississippi_riverine.for	forests/trees/usa/lower_mississippi_riverine/evergreen_dense/forest.for
evergreen_dense-middle_rocky_mountain.for	forests/trees/usa/middle_rocky_mountain/evergreen_dense/forest.for
evergreen_dense-nevada_utah_mountains.for	forests/trees/usa/nevada_utah_mountains/evergreen_dense/forest.for
evergreen_dense-northern_rocky_mountain.for	forests/trees/usa/northern_rocky_mountain/evergreen_dense/forest.for
evergreen_dense-ouachita.for	forests/trees/usa/ouachita/evergreen_dense/forest.for
evergreen_dense-outer_coastal_plain.for	forests/trees/usa/outer_coastal_plain/evergreen_dense/forest.for
evergreen_dense-ozark.for	forests/trees/usa/ozark/evergreen_dense/forest.for
evergreen_dense-pacific_lowland.for	forests/trees/usa/pacific_lowland/evergreen_dense/forest.for
evergreen_dense-prairie_parkland_subtropical.for	forests/trees/usa/prairie_parkland_subtropical/evergreen_dense/forest.for
evergreen_dense-prairie_parkland_temperate.for	forests/trees/usa/prairie_parkland_temperate/evergreen_dense/forest.for
evergreen_dense-sierran_steppe_sequoias.for	forests/trees/usa/sierran_steppe_sequoias/evergreen_dense/forest.for
evergreen_dense-sierran_steppe.for	forests/trees/usa/sierran_steppe/evergreen_dense/forest.for
evergreen_dense-southeastern.for	forests/trees/usa/southeastern/evergreen_dense/forest.for
evergreen_dense-southern_rocky_mountain.for	forests/trees/usa/southern_rocky_mountain/evergreen_dense/forest.for
evergreen_dense-southwest_plateau_and_plains.for	forests/trees/usa/southwest_plateau_and_plains/evergreen_dense/forest.for
evergreen_sparse-adirondack_new_england.for	forests/trees/usa/adirondack_new_england/evergreen_sparse/forest.for
evergreen_sparse-american_semi_desert_and_desert.for	forests/trees/usa/american_semi_desert_and_desert/evergreen_sparse/forest.for
evergreen_sparse-arizona_new_mexico.for	forests/trees/usa/arizona_new_mexico/evergreen_sparse/forest.for
evergreen_sparse-black_hills.for	forests/trees/usa/black_hills/evergreen_sparse/forest.for
evergreen_sparse-california_coastal_chapparra.for	forests/trees/usa/california_coastal_chapparra/evergreen_sparse/forest.for
evergreen_sparse-california_coastal_range.for	forests/trees/usa/california_coastal_range/evergreen_sparse/forest.for
evergreen_sparse-california_coastal_redwood.for	forests/trees/usa/california_coastal_redwood/evergreen_sparse/forest.for
evergreen_sparse-california_dry_steppe.for	forests/trees/usa/california_dry_steppe/evergreen_sparse/forest.for
evergreen_sparse-cascade.for	forests/trees/usa/cascade/evergreen_sparse/forest.for
evergreen_sparse-central_appalachian.for	forests/trees/usa/central_appalachian/evergreen_sparse/forest.for
evergreen_sparse-chihuahuan_semi_desert.for	forests/trees/usa/chihuahuan_semi_desert/evergreen_sparse/forest.for
evergreen_sparse-colorado_plateau_semi_desert.for	forests/trees/usa/colorado_plateau_semi_desert/evergreen_sparse/forest.for
evergreen_sparse-eastern_continental.for	forests/trees/usa/eastern_continental/evergreen_sparse/forest.for
evergreen_sparse-eastern_oceanic.for	forests/trees/usa/eastern_oceanic/evergreen_sparse/forest.for
evergreen_sparse-everglades_coast.for	forests/trees/usa/everglades_coast/evergreen_sparse/forest.for
evergreen_sparse-everglades.for	forests/trees/usa/everglades/evergreen_sparse/forest.for
evergreen_sparse-great_plains_palouse_dry_steppe.for	forests/trees/usa/great_plains_palouse_dry_steppe/evergreen_sparse/forest.for
evergreen_sparse-great_plains_steppe_and_shrub.for	forests/trees/usa/great_plains_steppe_and_shrub/evergreen_sparse/forest.for
evergreen_sparse-great_plains_steppe.for	forests/trees/usa/great_plains_steppe/evergreen_sparse/forest.for
evergreen_sparse-hawaiian_islands.for	forests/trees/usa/hawaiian_islands/evergreen_sparse/forest.for
evergreen_sparse-intermountain_semi_desert_and_desert.for	forests/trees/usa/intermountain_semi_desert_and_desert/evergreen_sparse/forest.for
evergreen_sparse-intermountain_semi_desert.for	forests/trees/usa/intermountain_semi_desert/evergreen_sparse/forest.for
evergreen_sparse-laurentian.for	forests/trees/usa/laurentian/evergreen_sparse/forest.for
evergreen_sparse-lower_mississippi_riverine.for	forests/trees/usa/lower_mississippi_riverine/evergreen_sparse/forest.for
evergreen_sparse-middle_rocky_mountain.for	forests/trees/usa/middle_rocky_mountain/evergreen_sparse/forest.for
evergreen_sparse-nevada_utah_mountains.for	forests/trees/usa/nevada_utah_mountains/evergreen_sparse/forest.for
evergreen_sparse-northern_rocky_mountain.for	forests/trees/usa/northern_rocky_mountain/evergreen_sparse/forest.for
evergreen_sparse-ouachita.for	forests/trees/usa/ouachita/evergreen_sparse/forest.for
evergreen_sparse-outer_coastal_plain.for	forests/trees/usa/outer_coastal_plain/evergreen_sparse/forest.for
evergreen_sparse-ozark.for	forests/trees/usa/ozark/evergreen_sparse/forest.for
evergreen_sparse-pacific_lowland.for	forests/trees/usa/pacific_lowland/evergreen_sparse/forest.for
evergreen_sparse-prairie_parkland_subtropical.for	forests/trees/usa/prairie_parkland_subtropical/evergreen_sparse/forest.for
evergreen_sparse-prairie_parkland_temperate.for	forests/trees/usa/prairie_parkland_temperate/evergreen_sparse/forest.for
evergreen_sparse-sierran_steppe_sequoias.for	forests/trees/usa/sierran_steppe_sequoias/evergreen_sparse/forest.for
evergreen_sparse-sierran_steppe.for	forests/trees/usa/sierran_steppe/evergreen_sparse/forest.for
evergreen_sparse-southeastern.for	forests/trees/usa/southeastern/evergreen_sparse/forest.for
evergreen_sparse-southern_rocky_mountain.for	forests/trees/usa/southern_rocky_mountain/evergreen_sparse/forest.for
evergreen_sparse-southwest_plateau_and_plains.for	forests/trees/usa/southwest_plateau_and_plains/evergreen_sparse/forest.for
mixed_dense-adirondack_new_england.for	forests/trees/usa/adirondack_new_england/mixed_dense/forest.for
mixed_dense-american_semi_desert_and_desert.for	forests/trees/usa/american_semi_desert_and_desert/mixed_dense/forest.for
mixed_dense-arizona_new_mexico.for	forests/trees/usa/arizona_new_mexico/mixed_dense/forest.for
mixed_dense-black_hills.for	forests/trees/usa/black_hills/mixed_dense/forest.for
mixed_dense-california_coastal_chapparra.for	forests/trees/usa/california_coastal_chapparra/mixed_dense/forest.for
mixed_dense-california_coastal_range.for	forests/trees/usa/california_coastal_range/mixed_dense/forest.for
mixed_dense-california_coastal_redwood.for	forests/trees/usa/california_coastal_redwood/mixed_dense/forest.for
mixed_dense-california_dry_steppe.for	forests/trees/usa/california_dry_steppe/mixed_dense/forest.for
mixed_dense-cascade.for	forests/trees/usa/cascade/mixed_dense/forest.for
mixed_dense-central_appalachian.for	forests/trees/usa/central_appalachian/mixed_dense/forest.for
mixed_dense-chihuahuan_semi_desert.for	forests/trees/usa/chihuahuan_semi_desert/mixed_dense/forest.for
mixed_dense-colorado_plateau_semi_desert.for	forests/trees/usa/colorado_plateau_semi_desert/mixed_dense/forest.for
mixed_dense-eastern_continental.for	forests/trees/usa/eastern_continental/mixed_dense/forest.for
mixed_dense-eastern_oceanic.for	forests/trees/usa/eastern_oceanic/mixed_dense/forest.for
mixed_dense-everglades_coast.for	forests/trees/usa/everglades_coast/mixed_dense/forest.for
mixed_dense-everglades.for	forests/trees/usa/everglades/mixed_dense/forest.for
mixed_dense-great_plains_palouse_dry_steppe.for	forests/trees/usa/great_plains_palouse_dry_steppe/mixed_dense/forest.for
mixed_dense-great_plains_steppe_and_shrub.for	forests/trees/usa/great_plains_steppe_and_shrub/mixed_dense/forest.for
mixed_dense-great_plains_steppe.for	forests/trees/usa/great_plains_steppe/mixed_dense/forest.for
mixed_dense-hawaiian_islands.for	forests/trees/usa/hawaiian_islands/mixed_dense/forest.for
mixed_dense-intermountain_semi_desert_and_desert.for	forests/trees/usa/intermountain_semi_desert_and_desert/mixed_dense/forest.for
mixed_dense-intermountain_semi_desert.for	forests/trees/usa/intermountain_semi_desert/mixed_dense/forest.for
mixed_dense-laurentian.for	forests/trees/usa/laurentian/mixed_dense/forest.for
mixed_dense-lower_mississippi_riverine.for	forests/trees/usa/lower_mississippi_riverine/mixed_dense/forest.for
mixed_dense-middle_rocky_mountain.for	forests/trees/usa/middle_rocky_mountain/mixed_dense/forest.for
mixed_dense-nevada_utah_mountains.for	forests/trees/usa/nevada_utah_mountains/mixed_dense/forest.for
mixed_dense-northern_rocky_mountain.for	forests/trees/usa/northern_rocky_mountain/mixed_dense/forest.for
mixed_dense-ouachita.for	forests/trees/usa/ouachita/mixed_dense/forest.for
mixed_dense-outer_coastal_plain.for	forests/trees/usa/outer_coastal_plain/mixed_dense/forest.for
mixed_dense-ozark.for	forests/trees/usa/ozark/mixed_dense/forest.for
mixed_dense-pacific_lowland.for	forests/trees/usa/pacific_lowland/mixed_dense/forest.for
mixed_dense-prairie_parkland_subtropical.for	forests/trees/usa/prairie_parkland_subtropical/mixed_dense/forest.for
mixed_dense-prairie_parkland_temperate.for	forests/trees/usa/prairie_parkland_temperate/mixed_dense/forest.for
mixed_dense-sierran_steppe_sequoias.for	forests/trees/usa/sierran_steppe_sequoias/mixed_dense/forest.for
mixed_dense-sierran_steppe.for	forests/trees/usa/sierran_steppe/mixed_dense/forest.for
mixed_dense-southeastern.for	forests/trees/usa/southeastern/mixed_dense/forest.for
mixed_dense-southern_rocky_mountain.for	forests/trees/usa/southern_rocky_mountain/mixed_dense/forest.for
mixed_dense-southwest_plateau_and_plains.for	forests/trees/usa/southwest_plateau_and_plains/mixed_dense/forest.for
mixed_sparse-adirondack_new_england.for	forests/trees/usa/adirondack_new_england/mixed_sparse/forest.for
mixed_sparse-american_semi_desert_and_desert.for	forests/trees/usa/american_semi_desert_and_desert/mixed_sparse/forest.for
mixed_sparse-arizona_new_mexico.for	forests/trees/usa/arizona_new_mexico/mixed_sparse/forest.for
mixed_sparse-black_hills.for	forests/trees/usa/black_hills/mixed_sparse/forest.for
mixed_sparse-california_coastal_chapparra.for	forests/trees/usa/california_coastal_chapparra/mixed_sparse/forest.for
mixed_sparse-california_coastal_range.for	forests/trees/usa/california_coastal_range/mixed_sparse/forest.for
mixed_sparse-california_coastal_redwood.for	forests/trees/usa/california_coastal_redwood/mixed_sparse/forest.for
mixed_sparse-california_dry_steppe.for	forests/trees/usa/california_dry_steppe/mixed_sparse/forest.for
mixed_sparse-cascade.for	forests/trees/usa/cascade/mixed_sparse/forest.for
mixed_sparse-central_appalachian.for	forests/trees/usa/central_appalachian/mixed_sparse/forest.for
mixed_sparse-chihuahuan_semi_desert.for	forests/trees/usa/chihuahuan_semi_desert/mixed_sparse/forest.for
mixed_sparse-colorado_plateau_semi_desert.for	forests/trees/usa/colorado_plateau_semi_desert/mixed_sparse/forest.for
mixed_sparse-eastern_continental.for	forests/trees/usa/eastern_continental/mixed_sparse/forest.for
mixed_sparse-eastern_oceanic.for	forests/trees/usa/eastern_oceanic/mixed_sparse/forest.for
mixed_sparse-everglades_coast.for	forests/trees/usa/everglades_coast/mixed_sparse/forest.for
mixed_sparse-everglades.for	forests/trees/usa/everglades/mixed_sparse/forest.for
mixed_sparse-great_plains_palouse_dry_steppe.for	forests/trees/usa/great_plains_palouse_dry_steppe/mixed_sparse/forest.for
mixed_sparse-great_plains_steppe_and_shrub.for	forests/trees/usa/great_plains_steppe_and_shrub/mixed_sparse/forest.for
mixed_sparse-great_plains_steppe.for	forests/trees/usa/great_plains_steppe/mixed_sparse/forest.for
mixed_sparse-hawaiian_islands.for	forests/trees/usa/hawaiian_islands/mixed_sparse/forest.for
mixed_sparse-intermountain_semi_desert_and_desert.for	forests/trees/usa/intermountain_semi_desert_and_desert/mixed_sparse/forest.for
mixed_sparse-intermountain_semi_desert.for	forests/trees/usa/intermountain_semi_desert/mixed_sparse/forest.for
mixed_sparse-laurentian.for	forests/trees/usa/laurentian/mixed_sparse/forest.for
mixed_sparse-lower_mississippi_riverine.for	forests/trees/usa/lower_mississippi_riverine/mixed_sparse/forest.for
mixed_sparse-middle_rocky_mountain.for	forests/trees/usa/middle_rocky_mountain/mixed_sparse/forest.for
mixed_sparse-nevada_utah_mountains.for	forests/trees/usa/nevada_utah_mountains/mixed_sparse/forest.for
mixed_sparse-northern_rocky_mountain.for	forests/trees/usa/northern_rocky_mountain/mixed_sparse/forest.for
mixed_sparse-ouachita.for	forests/trees/usa/ouachita/mixed_sparse/forest.for
mixed_sparse-outer_coastal_plain.for	forests/trees/usa/outer_coastal_plain/mixed_sparse/forest.for
mixed_sparse-ozark.for	forests/trees/usa/ozark/mixed_sparse/forest.for
mixed_sparse-pacific_lowland.for	forests/trees/usa/pacific_lowland/mixed_sparse/forest.for
mixed_sparse-prairie_parkland_subtropical.for	forests/trees/usa/prairie_parkland_subtropical/mixed_sparse/forest.for
mixed_sparse-prairie_parkland_temperate.for	forests/trees/usa/prairie_parkland_temperate/mixed_sparse/forest.for
mixed_sparse-sierran_steppe_sequoias.for	forests/trees/usa/sierran_steppe_sequoias/mixed_sparse/forest.for
mixed_sparse-sierran_steppe.for	forests/trees/usa/sierran_steppe/mixed_sparse/forest.for
mixed_sparse-southeastern.for	forests/trees/usa/southeastern/mixed_sparse/forest.for
mixed_sparse-southern_rocky_mountain.for	forests/trees/usa/southern_rocky_mountain/mixed_sparse/forest.for
mixed_sparse-southwest_plateau_and_plains.for	forests/trees/usa/southwest_plateau_and_plains/mixed_sparse/forest.for
pasture-adirondack_new_england.for	forests/trees/usa/adirondack_new_england/pasture/forest.for
pasture-american_semi_desert_and_desert.for	forests/trees/usa/american_semi_desert_and_desert/pasture/forest.for
pasture-arizona_new_mexico.for	forests/trees/usa/arizona_new_mexico/pasture/forest.for
pasture-black_hills.for	forests/trees/usa/black_hills/pasture/forest.for
pasture-california_coastal_chapparra.for	forests/trees/usa/california_coastal_chapparra/pasture/forest.for
pasture-california_coastal_range.for	forests/trees/usa/california_coastal_range/pasture/forest.for
pasture-california_coastal_redwood.for	forests/trees/usa/california_coastal_redwood/pasture/forest.for
pasture-california_dry_steppe.for	forests/trees/usa/california_dry_steppe/pasture/forest.for
pasture-cascade.for	forests/trees/usa/cascade/pasture/forest.for
pasture-central_appalachian.for	forests/trees/usa/central_appalachian/pasture/forest.for
pasture-chihuahuan_semi_desert.for	forests/trees/usa/chihuahuan_semi_desert/pasture/forest.for
pasture-colorado_plateau_semi_desert.for	forests/trees/usa/colorado_plateau_semi_desert/pasture/forest.for
pasture-eastern_continental.for	forests/trees/usa/eastern_continental/pasture/forest.for
pasture-eastern_oceanic.for	forests/trees/usa/eastern_oceanic/pasture/forest.for
pasture-everglades_coast.for	forests/trees/usa/everglades_coast/pasture/forest.for
pasture-everglades.for	forests/trees/usa/everglades/pasture/forest.for
pasture-great_plains_palouse_dry_steppe.for	forests/trees/usa/great_plains_palouse_dry_steppe/pasture/forest.for
pasture-great_plains_steppe_and_shrub.for	forests/trees/usa/great_plains_steppe_and_shrub/pasture/forest.for
pasture-great_plains_steppe.for	forests/trees/usa/great_plains_steppe/pasture/forest.for
pasture-hawaiian_islands.for	forests/trees/usa/hawaiian_islands/pasture/forest.for
pasture-intermountain_semi_desert_and_desert.for	forests/trees/usa/intermountain_semi_desert_and_desert/pasture/forest.for
pasture-intermountain_semi_desert.for	forests/trees/usa/intermountain_semi_desert/pasture/forest.for
pasture-laurentian.for	forests/trees/usa/laurentian/pasture/forest.for
pasture-lower_mississippi_riverine.for	forests/trees/usa/lower_mississippi_riverine/pasture/forest.for
pasture-middle_rocky_mountain.for	forests/trees/usa/middle_rocky_mountain/pasture/forest.for
pasture-nevada_utah_mountains.for	forests/trees/usa/nevada_utah_mountains/pasture/forest.for
pasture-northern_rocky_mountain.for	forests/trees/usa/northern_rocky_mountain/pasture/forest.for
pasture-ouachita.for	forests/trees/usa/ouachita/pasture/forest.for
pasture-outer_coastal_plain.for	forests/trees/usa/outer_coastal_plain/pasture/forest.for
pasture-ozark.for	forests/trees/usa/ozark/pasture/forest.for
pasture-pacific_lowland.for	forests/trees/usa/pacific_lowland/pasture/forest.for
pasture-prairie_parkland_subtropical.for	forests/trees/usa/prairie_parkland_subtropical/pasture/forest.for
pasture-prairie_parkland_temperate.for	forests/trees/usa/prairie_parkland_temperate/pasture/forest.for
pasture-sierran_steppe_sequoias.for	forests/trees/usa/sierran_steppe_sequoias/pasture/forest.for
pasture-sierran_steppe.for	forests/trees/usa/sierran_steppe/pasture/forest.for
pasture-southeastern.for	forests/trees/usa/southeastern/pasture/forest.for
pasture-southern_rocky_mountain.for	forests/trees/usa/southern_rocky_mountain/pasture/forest.for
pasture-southwest_plateau_and_plains.for	forests/trees/usa/southwest_plateau_and_plains/pasture/forest.for
residential_low-american_semi_desert_and_desert.for	forests/trees/usa/american_semi_desert_and_desert/residential_low/forest.for
residential_low-california_coastal_chapparra.for	forests/trees/usa/california_coastal_chapparra/residential_low/forest.for
residential_low-california_coastal_range.for	forests/trees/usa/california_coastal_range/residential_low/forest.for
residential_low-california_dry_steppe.for	forests/trees/usa/california_dry_steppe/residential_low/forest.for
residential_low-chihuahuan_semi_desert.for	forests/trees/usa/chihuahuan_semi_desert/residential_low/forest.for
residential_low-everglades_coast.for	forests/trees/usa/everglades_coast/residential_low/forest.for
residential_low-everglades.for	forests/trees/usa/everglades/residential_low/forest.for
residential_low-great_plains_palouse_dry_steppe.for	forests/trees/usa/great_plains_palouse_dry_steppe/residential_low/forest.for
residential_low-great_plains_steppe.for	forests/trees/usa/great_plains_steppe/residential_low/forest.for
residential_low-outer_coastal_plain.for	forests/trees/usa/outer_coastal_plain/residential_low/forest.for
residential_low-southwest_plateau_and_plains.for	forests/trees/usa/southwest_plateau_and_plains/residential_low/forest.for
shrub-adirondack_new_england.for	forests/trees/usa/adirondack_new_england/shrub/forest.for
shrub-american_semi_desert_and_desert.for	forests/trees/usa/american_semi_desert_and_desert/shrub/forest.for
shrub-arizona_new_mexico.for	forests/trees/usa/arizona_new_mexico/shrub/forest.for
shrub-black_hills.for	forests/trees/usa/black_hills/shrub/forest.for
shrub-california_coastal_chapparra.for	forests/trees/usa/california_coastal_chapparra/shrub/forest.for
shrub-california_coastal_range.for	forests/trees/usa/california_coastal_range/shrub/forest.for
shrub-california_coastal_redwood.for	forests/trees/usa/california_coastal_redwood/shrub/forest.for
shrub-california_dry_steppe.for	forests/trees/usa/california_dry_steppe/shrub/forest.for
shrub-cascade.for	forests/trees/usa/cascade/shrub/forest.for
shrub-central_appalachian.for	forests/trees/usa/central_appalachian/shrub/forest.for
shrub-chihuahuan_semi_desert.for	forests/trees/usa/chihuahuan_semi_desert/shrub/forest.for
shrub-colorado_plateau_semi_desert.for	forests/trees/usa/colorado_plateau_semi_desert/shrub/forest.for
shrub-eastern_continental.for	forests/trees/usa/eastern_continental/shrub/forest.for
shrub-eastern_oceanic.for	forests/trees/usa/eastern_oceanic/shrub/forest.for
shrub-everglades_coast.for	forests/trees/usa/everglades_coast/shrub/forest.for
shrub-everglades.for	forests/trees/usa/everglades/shrub/forest.for
shrub-great_plains_palouse_dry_steppe.for	forests/trees/usa/great_plains_palouse_dry_steppe/shrub/forest.for
shrub-great_plains_steppe_and_shrub.for	forests/trees/usa/great_plains_steppe_and_shrub/shrub/forest.for
shrub-great_plains_steppe.for	forests/trees/usa/great_plains_steppe/shrub/forest.for
shrub-hawaiian_islands.for	forests/trees/usa/hawaiian_islands/shrub/forest.for
shrub-intermountain_semi_desert_and_desert.for	forests/trees/usa/intermountain_semi_desert_and_desert/shrub/forest.for
shrub-intermountain_semi_desert.for	forests/trees/usa/intermountain_semi_desert/shrub/forest.for
shrub-laurentian.for	forests/trees/usa/laurentian/shrub/forest.for
shrub-lower_mississippi_riverine.for	forests/trees/usa/lower_mississippi_riverine/shrub/forest.for
shrub-middle_rocky_mountain.for	forests/trees/usa/middle_rocky_mountain/shrub/forest.for
shrub-nevada_utah_mountains.for	forests/trees/usa/nevada_utah_mountains/shrub/forest.for
shrub-northern_rocky_mountain.for	forests/trees/usa/northern_rocky_mountain/shrub/forest.for
shrub-ouachita.for	forests/trees/usa/ouachita/shrub/forest.for
shrub-outer_coastal_plain.for	forests/trees/usa/outer_coastal_plain/shrub/forest.for
shrub-ozark.for	forests/trees/usa/ozark/shrub/forest.for
shrub-pacific_lowland.for	forests/trees/usa/pacific_lowland/shrub/forest.for
shrub-prairie_parkland_subtropical.for	forests/trees/usa/prairie_parkland_subtropical/shrub/forest.for
shrub-prairie_parkland_temperate.for	forests/trees/usa/prairie_parkland_temperate/shrub/forest.for
shrub-sierran_steppe_sequoias.for	forests/trees/usa/sierran_steppe_sequoias/shrub/forest.for
shrub-sierran_steppe.for	forests/trees/usa/sierran_steppe/shrub/forest.for
shrub-southeastern.for	forests/trees/usa/southeastern/shrub/forest.for
shrub-southern_rocky_mountain.for	forests/trees/usa/southern_rocky_mountain/shrub/forest.for
shrub-southwest_plateau_and_plains.for	forests/trees/usa/southwest_plateau_and_plains/shrub/forest.for
woodywetland-adirondack_new_england.for	forests/trees/usa/adirondack_new_england/woodywetland/forest.for
woodywetland-american_semi_desert_and_desert.for	forests/trees/usa/american_semi_desert_and_desert/woodywetland/forest.for
woodywetland-arizona_new_mexico.for	forests/trees/usa/arizona_new_mexico/woodywetland/forest.for
woodywetland-black_hills.for	forests/trees/usa/black_hills/woodywetland/forest.for
woodywetland-california_coastal_chapparra.for	forests/trees/usa/california_coastal_chapparra/woodywetland/forest.for
woodywetland-california_coastal_range.for	forests/trees/usa/california_coastal_range/woodywetland/forest.for
woodywetland-california_coastal_redwood.for	forests/trees/usa/california_coastal_redwood/woodywetland/forest.for
woodywetland-california_dry_steppe.for	forests/trees/usa/california_dry_steppe/woodywetland/forest.for
woodywetland-cascade.for	forests/trees/usa/cascade/woodywetland/forest.for
woodywetland-central_appalachian.for	forests/trees/usa/central_appalachian/woodywetland/forest.for
woodywetland-chihuahuan_semi_desert.for	forests/trees/usa/chihuahuan_semi_desert/woodywetland/forest.for
woodywetland-colorado_plateau_semi_desert.for	forests/trees/usa/colorado_plateau_semi_desert/woodywetland/forest.for
woodywetland-eastern_continental.for	forests/trees/usa/eastern_continental/woodywetland/forest.for
woodywetland-eastern_oceanic.for	forests/trees/usa/eastern_oceanic/woodywetland/forest.for
woodywetland-everglades_coast.for	forests/trees/usa/everglades_coast/woodywetland/forest.for
woodywetland-everglades.for	forests/trees/usa/everglades/woodywetland/forest.for
woodywetland-great_plains_palouse_dry_steppe.for	forests/trees/usa/great_plains_palouse_dry_steppe/woodywetland/forest.for
woodywetland-great_plains_steppe_and_shrub.for	forests/trees/usa/great_plains_steppe_and_shrub/woodywetland/forest.for
woodywetland-great_plains_steppe.for	forests/trees/usa/great_plains_steppe/woodywetland/forest.for
woodywetland-hawaiian_islands.for	forests/trees/usa/hawaiian_islands/woodywetland/forest.for
woodywetland-intermountain_semi_desert_and_desert.for	forests/trees/usa/intermountain_semi_desert_and_desert/woodywetland/forest.for
woodywetland-intermountain_semi_desert.for	forests/trees/usa/intermountain_semi_desert/woodywetland/forest.for
woodywetland-laurentian.for	forests/trees/usa/laurentian/woodywetland/forest.for
woodywetland-lower_mississippi_riverine.for	forests/trees/usa/lower_mississippi_riverine/woodywetland/forest.for
woodywetland-middle_rocky_mountain.for	forests/trees/usa/middle_rocky_mountain/woodywetland/forest.for
woodywetland-nevada_utah_mountains.for	forests/trees/usa/nevada_utah_mountains/woodywetland/forest.for
woodywetland-northern_rocky_mountain.for	forests/trees/usa/northern_rocky_mountain/woodywetland/forest.for
woodywetland-ouachita.for	forests/trees/usa/ouachita/woodywetland/forest.for
woodywetland-outer_coastal_plain.for	forests/trees/usa/outer_coastal_plain/woodywetland/forest.for
woodywetland-ozark.for	forests/trees/usa/ozark/woodywetland/forest.for
woodywetland-pacific_lowland.for	forests/trees/usa/pacific_lowland/woodywetland/forest.for
woodywetland-prairie_parkland_subtropical.for	forests/trees/usa/prairie_parkland_subtropical/woodywetland/forest.for
woodywetland-prairie_parkland_temperate.for	forests/trees/usa/prairie_parkland_temperate/woodywetland/forest.for
woodywetland-sierran_steppe_sequoias.for	forests/trees/usa/sierran_steppe_sequoias/woodywetland/forest.for
woodywetland-sierran_steppe.for	forests/trees/usa/sierran_steppe/woodywetland/forest.for
woodywetland-southeastern.for	forests/trees/usa/southeastern/woodywetland/forest.for
woodywetland-southern_rocky_mountain.for	forests/trees/usa/southern_rocky_mountain/woodywetland/forest.for
woodywetland-southwest_plateau_and_plains.for	forests/trees/usa/southwest_plateau_and_plains/woodywetland/forest.for